NO ./assets/Ice/Photoreal_Ice_01-512x512.png
EA ./assets/Ice/Photoreal_Ice_02-512x512.png
WE ./assets/Ice/Photoreal_Ice_03-512x512.png
SO ./assets/Ice/Photoreal_Ice_04-512x512.png
DO ./textures/pics/eagle.png

F 127,127,127
C 0,100,200

1111111111
1100000001
1001010001
10010000011111111111
10000N000000       1
1000000001101      1
1011111111101      1
1011101110001      1
1000000000001      1
11111111111111111111
