NO ./assets/textures/graffiti_6.png
SO ./assets/textures/graffiti_7.png
WE ./assets/textures/bricks_0001_color_2k.png
EA ./assets/textures/graffiti_8.png

F 43,17,18
C 39,55,82

1111111111111111111111111111111111111111
1011111101011000110111011100000101111001
1111001100100101011001111100100011001011
1110001001000111001100010101100111011001
1110100000000010001110011100001100101111
1001101011110101010111100001110010111011
1100100001101101011111100111000101000101
1100010110101111010011101110010011010101
1011010110111110110111110111110111010111
1000001110111111100000100101000010101001
1111010000010101111010001111100011000011
1111100100100101001101011101100001000111
1100111011101011010110010110100011010101
1001111000011100111111010001100010100111
1100001101110001011010110110101110000011
1100011010100001110011100000001100000011
1001111100111000010001111100101000101101
1101100000100010011101000110001111100101
1011100100100101010100100100110101101111
1011100010100011010000110101101010111101
1110100010010101000100111001011100001001
1101110010011110010100100101110011100111
1100101110111100010111000100001000010111
1001111000100101011011000001000000011101
1001100110000111100101001000100100100111
1000001110000000011011100011111111010101
1111000000100101001111011100010011111011
1111011010110001001000101101100101100101
1111010111011110001100011110000111110111
1001010000010111111010100010010101101011
1001011001100000000000110011010100110001
1010111011101111100011111110010100010011
1110001100100000011000100110100011010101
1111010111101110001001110001111100000101
1000001100111111111011101110011000010011
1110111101011110000000101111001111011011
1001100011010101110000110100111111010001
1010110100001110001101111111010000010111
1010100111100011101111101101001000111101
1111011101110100000110000111000001100111
1011100011011100000111101110011011110011
1001011110110111000110111001011010000111
1001101011010110001001010101011000110011
1100110110111110001000110111110111100101
1111001010100101011110110100110100100101
1010001110001110100000110010110000011101
1001110000110001101000010011010001001111
1111101011001101011001100111001100011101
1111000110111100111100110101100100001101
1111110111101111100110000100000010001111
1010001001001110000110110101001000100111
1010111110101010101100101010101101101001
1010110011111001111001110101001000001111
1000010110001000010000011110111100111011
1101100001000010001011001011000110000001
1010100101010110000001111101111100010111
1100011110000001001011111110111110000111
1000110101101010001111000101101000110011
1101011101111100101101101001011000010001
1011011100010010001111010101111100010111
1101000000101100101010001011010101011001
1010110101101100111110111110001010001001
1010110111101111101010101110111101110111
1111010000000100000010111001010011111111
1000001111000000010000010010010010000101
1111101110011100111000100000011110101011
1010100111001100001010111010101010001001
1110100011000111000001110111001100010101
1100011111001110111001010111010001101111
1010011101001010001001001011111011001001
1110000101101010111000010001011000110001
1010011110010111011101100000000101101011
1111111101101000001100001111100001111111
1011111011001010011101101110100111011101
1100000111010101011001110000101000010011
1000111111110000000100100001100111000011
1001010111110101111011000111110010110111
1010111001011100010100111010000011011101
1010111101101000010111000011001110100111
1010000101111011001010111110100101110011
1100101011001001100011100110010001000011
1110011010110110101000110010000010110111
1101111001000010111111111000101010101011
1011110110101010000101001111000100001101
1011100110101010000011100000110101111101
1011011111100101111110111101011100100001
1000101110101111001101000100000101011011
1000011110110101000100111100111010010101
1111100110011110000000100010111101111101
1000110100100010000011101000111011010101
1111001110000111010001101101101000010111
1110101001001111111111011100011110000011
1100110001100101111000110001001110010111
1000001110001101000010000110100001111011
1000110001000010010111101111000010111011
1000111111101011110010111111110000010101
1100000111101001010011111111010011010011
1001110010111010010111100010010000010101
1011011000001100111100111110000111111111
1001101100100010010001011100111100001001
1101000111100101010011100011100111011111
1110111110100111101010101111001111101111
1001100111101011100110001100110010111011
1001010100011000101011001101110000110001
1100011001101111001111110111111110100111
1010111010101111001011101110100100110111
1001001000111000111011001001111111101001
1101001111010010010101000101111000110101
1111111010000001100000101010100011110001
1111010110011100110101100100011111101011
1000000010011011100001100101011101100001
1011011000111101011000111001011100101001
1111111011101101000111001101010101000011
1010000110000110111010101001000110110001
1110010111000010111100000010011000101111
1010110101000101000011110001100000111101
1010100011110001000101110010111111011111
1110001100110000001100110010010101011001
1111100100100110101000111100110000001111
1101011110111001000001001000110001100101
1111001101010010100010111011101100110001
1110100101011000110100001000010100111001
1111111100001001101000000101001101100111
1011001111011011100001010010110101101011
1001100011111111001101101011001011100101
1001011111100110101011011010001000001111
1001001011100110111001100010011000101001
1010001101100001010111111101101010100101
1000111111001101010010011000000111111011
1110000101111000001010010011111111011011
1001100101000111000101010100010110000001
1100110011101110000010101110100110001111
1111111110100111111100111100111000010001
1101110101000101000110011110010011101101
1000110100011011000000111010110001111001
1101000111111111110011110011011110101001
1011111111100101101111111100100101000101
1010001000000110001001110111110101100111
1101011000110000101000100100001001001011
1011001101101000111101100001010101010011
1010010100111011011001000000101110010111
1011000010100001000000011110101001001101
1100001100111100000011111001110010100011
1101011011110000111010011111001010010001
1001111111111100111101000110011100000111
1011110100110110101110001001001000010101
1010100100100000111111110110000001100111
1011101000110101001100101001100101010111
1010010001110000111000011111000010110101
1101111100111011001000111000011011010111
1010010011000110101001101010111011110011
1001101001010001001110111010101100111001
1111100101111011110110000010100100011001
1001101011110100110000100010011010010011
1000001110010111101010111101011011000011
1010001000001101111111101001101100111101
1010100010001111110010011110001011000011
1110110101010110101110101000100101110101
1100000110111111110110111011001001101001
1001101010101111100110011100110101100011
1101111010010001101101000110011100111001
1110101110100100111011100011101111101011
1011111010000101000011011101100111010001
1011101001000010001000110000010011100101
1111011010100001100001110010011000100111
1000000111111111101011100101111011100011
1111111000111011011101011111000100100001
1101111110011010001110011101001011001001
1010001111101100001001011001111101101011
1101001111011010001110000010110111110001
1001100110010110101101011100011101111001
1110101110110101101010111111110100101101
1111001100011111111111110101001010010101
1101111110101111101101000010110111100101
1000100111101001100011110100110000000101
1110010000011010100100111011010111100001
1011100101010100000100001000010101000001
1000000101110000101100010100111100100001
1001110101000001000011010111101001001101
1010010101101000000100001110110111000001
1010101110000010010110110001010011010101
1001001010001010101001000001100101010101
1011100011011001010110110100010001000101
1010000011100111000110000001110111111101
1010111000110111010100101101101011110111
1011111111110011010110011101110101100001
1101000111011100110001101101000000111001
1010111111110110110110101011111000000011
1111111110110000111101100001000110000101
1010111100010000100101010010111111001001
1011110001100100101000100010100001100101
1001011011101111000011001101101101111101
1101001101001010001000111010110000011011
1111000110101001110110000000101011111101
1011001000010100101000110110011111011101
1111011000111110011100100011111110110011
1001111001001101101101011100011101110111
1010101011110010000010110111000010000001
1111101101001111000010010000011101010001
1111011010010101010110011110000101110011
1010101111100111110101111111100000011111
1001110001011100101011111011110011110001
1000010010010011111001111110101100101001
1100110110111101010110101011011010010001
1101100001100001101101101100111111011101
1000001110111111001100101001010011001011
1101111111010000100111000000101000101001
1011010000101101001001101010010100011111
1010101111111000000111010001101011110001
1011110111110110000011100001010001111011
1001101011010010110100010010111110101011
1100111100100100111110100111111101000011
1001011110100100101110111001110101011001
1101101011010010110001001011100100110001
1001011111000100011000011100000011000101
1001101110110000001010101011100111001001
1111111001110001100111101110010010011101
1100110101000011010101011010101010011001
1100100111111010001000101000000010100101
1010101110110101011111111100111110111101
1111100011110001011010010110101110111111
1101110010000101000001001110100111011101
1100011010001011011110000101110010001101
1100011011001110000000010001101011101111
1000110011010100110101101000111001101111
1011100110001011101010000100010111111101
1000110000010101101011100111100111001001
1100101010010001001001110000100011010101
1101101110101101100100000101101011101001
1110111010011101110100000000010101001101
1001111010111000000010101111000111100111
1010110000101101001110010100010101001001
1111100100000101100000010000110011101001
1100111010001010101010100101000000111111
1101111110111000101111001001110010000101
1110010111000010010010100101100011110101
1110110010101000000111011010100110100001
1100111000111000000001101001101111111001
1110001101001000010001111000111001101111
1000100100100010101001001010101100001011
1000110010010110100101010101010001011001
1111001011110011011101111011010000001111
1011010001101000000101111111110110010111
1000011110101001101001100011010100101101
1011110100001001000001010100101011100101
1100010100101101110000111001110101111111
1010000001111100001101111010110100011011
1001110100111000111011101000001001110011
1101010010001100110111010101110011010111
1001001111101000110110000101000010100001
1010101000110001010011010110100000000111
1100001011001111011000000011010100110111
1000110111011110101111110000000010111001
1010100110111000001101011111111001100101
1010110101000001000000010101000110001001
1000111001110111010010110000110111010001
1100010011011011110110010110101011010011
1110011001100111000010011011100000100111
1001111111010100100110111101011000010111
1000101000001011000001010000100101110001
1111111110011001000000100110011011011001
1010100010110001100101110111101111100011
1111101001101000001000110101110011100011
1110101001111110011000000100011000010101
1110100100110010011011010101111010010001
1101110110010100110111100111110001111001
1111110110011011000010001101011111000001
1000010000001110001101011011110000111011
1000010101010000010100100011100000011011
1100111101110110001101010000101010100001
1011000010101011011110011100101010110111
1111100111111110010001010100100110100011
1101010001010101000100110001111011101111
1010101000000010111011101010111100111101
1010111110110010100110111100010110000011
1110000000100111011110101100000000011111
1000111100110111010010110001110110100011
1000110111101110000111110111010100000111
1100011101101011011010000101011011101111
1110000000001000110101110101111100010001
1100001100100101110010010100000100011001
1101010010111011110110101010111101001001
1110100010101000011100111010100010001001
1000111011010101000001011111000001110111
1010010101000110010100101101000001001001
1110011011001011100011110101110010000001
1111001010000010010110111101011000100111
1111010111110010101000110011111001110101
1111001111011100010110110110000000101001
1101111100001011101110011100101110111101
1100000000100011100011110001100001010011
1001001001011101111100100101110011010011
1100000011101000111110111011010111001101
1001001000010100101100010011011111100101
1101011000111101000000100111001101001011
1111111011001100000001001001100011101101
1110111111110011001001100101000010011111
1110100001001010001010011111001001000001
1010001101111110100101101010110001000111
1110100010111110101010101010001110000101
1110111011101011110010100100100101101001
1111101001011111111000101100011010101101
1010011010011010100000111011100100011101
1101000111011100100001001110110011111101
1100011000010011101011010011011000010101
1100101111000000001001011111111011010101
1000000000100001010100010010100000100001
1111101101001010010000010010010101111001
1110000110110101100100111100000110000011
1000010010100000101001101001101101101111
1011000111001000111010000110111110011011
1011011101101000100010001100010000010001
1101110010000101110011000110010110101011
1101000111010110000101111110101101000101
1111111001011011010001100000010001111001
1010000100010001001011000011010100010001
1110111010010111011000001000111011010011
1110100001111001000111100110100101111001
1000011101101100110100000100111101100111
1001011111101111001111001011000011100001
1111110000110011110010100110011100011001
1001111011110010111010011101111011101111
1001111111101101110100001000110111100001
1110010110011001000000100100001101100001
1100001110110010110000110110000101101111
1001110011100010011111111100011100000011
1100110101101111000001100101101101110101
1101011001000100100100110010111011110011
1011101100011110010100000111111010010101
1111111101000011001010010110101010000011
1010111111001011111110101010010010011111
1101100111010101100100111111010010001111
1101000101100100110100010011100011000001
1100010010000011011100000101101101111101
1010001101000011101001101100011000010101
1010001110111101010010101100001000101111
1000111000101110010110101000101010101001
1101101010000101110100011111010100101101
1001111100000101010100000000011100000001
1010011011011001000000010110011011111001
1000010000111001111010001001011101101111
1001011001110001000111010001010001001101
1100110000100110110100101110101000100101
1011000010101101101101101001100000000001
1100010100111111100100010001111100011101
1110010111100101100100011100000010010011
1110001001100001001001000100011110101101
1010011101001110011110110011010011100001
1100010000100001010110001000000010011111
1011110111110000100001111110011100001011
1010001001001011111101010001010000000001
1110101100110111110010110000100000000001
1011100000001011011111001010011011111111
1101100100111001000110011111000111111111
1010101010010101000011000010101010011011
1000011000000010000101001010000100010111
1001000101100000010010110111101010011001
1010100010110111111000001010000001101101
1100010011101011111010001101001001111111
1101110111100111100011101100100000010001
1011001111100110010010110101100111100111
1001000100100010001101101110101001110001
1010100010011000101100101100101101100001
1111100010110000000110001000000100011101
1111110001111101001011001111111010110011
1010100010100000111010100100111110011101
1111001101000110111001001101101111000111
1001011000100100011101000101110001000011
10010000111100001111000100010100010110W1
1010100100000011011100111011111011100011
1001111001101111111011001100000101001011
1000011000100110010111000111110010110111
1111010011100000001100010100111001101101
1110011001111000100101001100000110100001
1000011101110000010001110100001100110101
1100110101111010101100001110111100001111
1010111001110011110010011111110100101111
1100100110101110010011101110000010010001
1001011011101111110001001000101111001001
1100000000111101010111010110101111010111
1001100111011101001011101100101101111101
1111001000011011111100011100011010110111
1011010011100000001011010000000010000101
1010100100010011100101000111000101100101
1001000001111000010101110100010010100011
1001010110010101111101110010001111000111
1111110001000000001000110110000111111001
1110010101101101110101011011011101111101
1000011000000111101011110101101001100011
1011000101001101110011001010110110011001
1001100110111101101010010000101101000001
1111011111011111100000100010111101001001
1101001101110011010111100001100011000111
1010111110000010001010110111010110111111
1010010000001100010101101110001000011111
1100010101111100001100101001111101011011
1111011100010101011110001011011111110101
1011100111001111011100110011000100111011
1000011001001110110101101011001001010001
1110000110011110000001100100011010000101
1110001100011101001110010011101011010101
1101101111001000000100101101011100111111
1110000101100101011001110010000011010101
1101000110111101001111000110000110101111
1101011101011001110001111100111001001001
1011101101001101011101010110110001110111
1010111100110010000001001110010110101001
1110010000111001111101111101111110101101
1001000111111111001010101100011101101101
1111110000000010111110111101011100000001
1011100111010110100111011010111001011111
1100100100001001010001000000000011110111
1110111101101110111010100101100101100111
1010101101010110011111101011111100011101
1111101010101110110000001001100010011101
1111011010111110001100001101011001100111
1100000001011101111110110000000110100011
1110010000101111001111111110011111010101
1011000011100100111010000110110011010101
1110001101010010010010111011001010101001
1011011000111101001000011100110001010101
1111011111010010101011110011010100011101
1000110110000100011111010110001101111101
1011111010110010111101000110100100100001
1110111111110000000010100110000111111101
1001001110000011100011011010001010011111
1110101100101100110101000011100110100111
1010100011100101011110100001110010010011
1110010100010011100001101110100101101001
1111100101010011100011010010111100110011
1110101000011010111101110110110110111001
1100010101010001001111001010101010111101
1001000000001000100111001001110111111011
1001111100010100011001010010010001001001
1001100011010101111100010110000110100001
1010101001011110000011101001100011011011
1101010100101101110101110110110111111001
1010000000110101111111000110011000000011
1100110101001110110110101011010110110111
1110011001001000111010001000001101111101
1111100000011100100110001101010001101111
1101011100111010110111111011110101111001
1111010111111000100110010110111101000001
1111100001110111011110101111010000000011
1010100110110011110110100110110000010011
1101110010111111101101010000011001111111
1111011010010100011111101011110000110101
1111011000011110111110010101001010010011
1111001010100110100100101111100011101101
1110100110010110010011001111010001000011
1100011010001110011010111001100000001001
1010000110100111000111010001000000000011
1101111101010010011000101111001000101001
1110111110000001100100111011000110010101
1010110011001111010010100101111011010011
1010110111101100100001011000110100110111
1110010011001000111000011010111011011011
1000010110011100010101011001110001011001
1001111000001110001111011011000000011111
1010111111100110001011000100101111011001
1100111010111000100101111010001110011001
1110101001111100011110010101101010110101
1001100101110000101111001010110011011101
1001010010110001001100011101101100011101
1000010110001100011010001100011011011001
1110010010001110011111010010111000000001
1111000011110011100110101100000001011101
1001110101000010110000011010111011010001
1011100000110000001011101110100011110001
1010011111010101011010001101001000110011
1001001110000010101001000110110011110101
1110010000100000110101011001000001001101
1001110010110111000101111100100000100111
1100101011111111010101010101110110000001
1111001100110101010001000010100000000101
1110100110001100101001100000000011010111
1111111011110001000100111000011101110111
1000000000101000001011100100100011100011
1111111001111000100010101111011111001101
1101011110011010101011000010100110001111
1000100000001001110011011111010110011111
1011100111010110011001010100110000011111
1101001000001001011001101111110000111011
1010101101000110011110011000010100111001
1000101010000111100000010100111110101011
1000001001011011000111110111101000100011
1011000110110001011110111110001001000001
1011100001101111001100000100010101100011
1001101101000110000100101101100111110111
1001011101110001011010100100000101010101
1101010100011000001000001111010000001001
1011101110011011110011000010000010001011
1000100010010010001100000111000000001101
1111110000111110001011001001000000101001
1100010011111100111101001110110000101011
1000111001110100011011100001110000111111
1011000001110010011111011110010100010001
1100111110011110100100101111111000111011
1010100100100000100110100111100110010011
1111111111111111111111111111111111111111