NO ./assets/Ice/Photoreal_Ice_01-512x512.png
EA ./assets/Ice/Photoreal_Ice_02-512x512.png
WE ./assets/Ice/Photoreal_Ice_03-512x512.png
SO ./assets/Ice/Photoreal_Ice_04-512x512.png

F 127,127,127
C 0,100,200

1111111111
110000000111
1001010001
1001000001111
10000N0000001
1000000001101
1011111111101
10111011100011111111111
100000000000000000000   1   1
111111111111111111111111111


