NO ./assets/Concrete copy/try_0.png
EA ./assets/Concrete copy/try_1.png
WE ./assets/Concrete copy/try_2.png
SO ./assets/Concrete copy/try_3.png

F 127,127,127
C 0,100,200

1111111111
110000000111
1001010001
1001000001111
10000N0000001
1000000001101
1011111111101                  11111
10111011100011111111111111    1001101
100000000000000000000    1   10001001
111111111111111111111111111   1111111



