NO ./assets/Concrete copy/try_0.png
EA ./assets/Concrete copy/try_1.png
WE ./assets/Concrete copy/try_2.png
SO        ./assets/Concrete copy/try_3.png


F 127,127,00000000000000000000000000127,,,,,,,,,,,,

C 0,100,200

111111111   
1  N 001111     111111
1111111  111  11010100000000000
11111111111    1111111