NO ./assets/textures/graffiti_6.png
SO ./assets/textures/graffiti_7.png
WE ./assets/textures/bricks_0001_color_2k.png
EA ./assets/textures/graffiti_8.png

F 115,89,56
C 108,184,255


        1111111111111111111111111
        1000000000110000000000001
        1011000001110000000000001
        1001000000000000000000001
111111111011000001110000000000001
100000000011000001110111111111111
11110111111111011100000010001
11110111  01111011101010010001
11000000110101011100000000001
100000000  0000001100000010001
10000000000000001101010000001
11000001110101011111011110N0111
11110111 1110101 1 1111010001
11111111 1111111 11111111111